0,100,200,200,50,0,0,0
0,300,400,10,50,0,0,0
0,0,300,40,50,0,0,0
0,25,425,100,50,0,0,0
0,300,0,40,30,0,0,0
0,0,475,500,25,0,0,0
0,340,425,25,50,0,0,0
0,350,200,200,50,0,0,0
1,50,300,200,25,1,1,500
1,10,20,50,20,2,0.5,300